fhj: afe puq pzy
avv: tve usj fft
hpi: you vlf mll
fmd: ses xxv
vtx: mje kjy ggs
kej: yyx
gcq: vdr ilr rra xfs tic ybr bfr xms tti rws qnn hpo rig
xpn: fym ams vxo
ggu: llp ehu uak
uar: gcq vlf mll
kye: aoy mim xsv ubi aht czb jos bnv fme gtv ywp ure zbb
oru: ufh sur
mrh: out
xcv: jet maj sql
tlf: ztj
zgu: yqg ccs
vcs: ftb
ecn: rts
dsc: uav qgg qtd
iaf: bmk dcm aus vue fhj
pxw: xrg zok iql
iql: cvu ete cog irt bux ggu qce nkv uum xxq opb lnt iaf cgc ygm
evg: ljm zqz
yno: smx
you: tti sfh hwd rig vxm bfr tec hpo rws tic
qce: ryx qgu rhm xql
bnv: wki
mva: zwn zik
elx: sfo icu
xsv: wiu kej
qdk: hjb
ywp: sqm
ffh: ylg net
lwu: iql zok rzm
pky: iyf wvy rvg
ioe: amw
sit: vlf gcq you zec
etj: you mll
vlf: rig nhi hpo qnn tti xjc vxm xms bfr ybr tic tec xfs rra ilr rqs hwd vdr
dyy: ylg bic
oot: xid zya xpk lts
xrg: iaf mhm zoa uum xxq opb ygm cgc zgu cog hdk cvu qce ifw nkv ggu bux yvi
gmy: ltt olr
xxb: btr
cbl: qod shi
jaw: ojs mrt
sbb: yzw
qgt: xrg rzm zok
wuk: tot ovj
jxh: rbb
dac: smm nrx hqe
etm: bsx
yjr: gvv
tec: hhb tux xcv
gce: xpn
ifw: dcm
jqj: gii ngp ere pcu
lru: hft
cxn: qgg
tly: fvi cre
msd: eqe cgl kaw
xui: gcq mll zec
hws: mjr hvu
atr: zec vlf mll
ifl: sqb
jet: vpk
dnp: hvy jeg
xjc: hws jie
kdu: ygd
yaw: gug msu unz
bwh: ypc
roo: adm hvu fmi mjr
bdg: iwx
fwv: oqu tpa mbz
xns: cyx
alh: kqq xqa
jlg: hin srk inu zhs
jwk: aht ulo ubi xsv byj mim wgh xvv ehy ywp bnv jos fme wjn czb yjn
ubi: wki tnc pby
mxn: wbq dnp
btr: gnn hew wgm wji
xff: smx dul wuo
aht: trg lml
nrs: zcw ycv vcm
xlq: yfm onj
lba: fmr qgt wsz
sij: fkf azt nop fbq
bov: zok xrg rzm
vue: puq afe
ams: msu unz
xms: roo jie
abl: ggj dsp oot
bsx: tve fft
pqc: hac lvi dmt tlf kth kzd etm yrx ebx mue
tcb: jqj gfy kqt nly
gov: zwn ykr rtt
xcb: wgm hew mvc gnn
whh: fqn oeu mrq
kla: zdg
qtw: uoe qts
alt: rts jju htm
fqn: fzs jaw chx wwy
dez: iyf wvy umq
ggj: zya xpk
yjn: gce lml sqm
zoa: dcm vue fhj
ovj: out
gvq: ygd fwv
hrz: out
dzh: wye bdf ytt
hpm: htm rts hjb jju
iwx: alt bxp xba
xqa: smi ehy czb bpn hvg gtv zbb nrs
bgq: hzx eqe cgl kaw
maj: for
pgt: ywl
ykr: gqf cxy
bxp: htm
ypc: out
olr: ntd lwu ptv
sgm: qgg qtd pqc
fmr: iql zok xrg
htm: evg ifl lru cjx vqq xys
uum: yqg ccs gao
rqs: xhf yfd dwp jrq
ztj: iwx
gnn: sbb
vlq: out
jth: nsr
iyf: zcr rvv
avk: zcr zev
olq: out
azt: out
ccs: hlv xew esi qtq
usj: skw czi ecn hlo
hjb: bla tfb lru oje xnt tcb dhl xff qom hha vqq yno cjx evg zll rkj gui whh wkd xlt
sqb: wsz fmr qgt
eyz: qtd qgg uav
hhb: maj sql
eqe: hjb rts jju
vpk: wuk okt jth
vdr: eaf dcl rqy
ztl: sfo gvv
wye: bwh jem zvu
rvg: gbx
xih: uav
beg: fwv csb kqv
pam: htm
foa: sfo
vcm: lmi
aks: you vlf
ftb: vlf gcq mll
uxb: zhs hin mzv
dcm: afe
wuo: qzg wop pxw
jem: qov ypc
okw: bdg qnb ztj
qod: vlf zec
qtd: qsv mue ysa okw ebx etm kth zkb
hjc: qtd pqc uav
lvp: qtd qgg
mzv: umt fuy
vmq: kye
zcr: rts jju htm
xhf: hva oqs
klr: dsc ygo sgm bvl
gug: mll
tux: maj
uim: bem dac gje
csb: uzn tpa
oks: rkm kvi
srk: ueh fuy umt nyh ioe
wkd: lgx sqb
rig: jrq xhf
ere: gmi ggg olr
qgq: buv wbq zdg
fmm: xag dez ans csl
doc: rvk cyx
puq: kqq
ggs: pam
rws: jie roo
nkv: ekg tqz jxh
cog: llp uak ehu
wbq: xih jeg
wrz: ssy
ajk: hod sit
pqr: xrg rzm zok
isk: mje kjy ggs
xip: fkf
zvu: qov qmv
yfm: uoe gxa
gtv: pby tnc
gii: gmi xwj ltt
onj: gxa
usz: wgm wji hew mvc gnn
fzs: cjf ojs
nhi: eaf dcl rqy
nsr: out
klt: wbq
mvt: usj tve
qnb: qhi kjv
bic: svh
yoi: fmd abl hcq xjt rhl jpv elf oks oxv mva qgq cih xxb klt kla ybg nzs qvh gov vvw tqb
xlt: jqj gfy aml nly
xxq: tly rhm ryx xql
gjq: xqa kye kqq jwk
zev: htm
vqq: xjw fqn yom oeu
bfr: amz uxb jlg
yfd: hva dzh
yvi: hbk ccs
opb: xql tly qgu
xpk: pxk lvp
zdg: hvy
bvu: kqv ygd csb
mor: nxo dko
avq: elx foa ztl quj
gui: smx wuo
svr: dth yoi nkf crg nnt
unz: zec gcq mll
wyg: sgm ygo dsc yzw bvl
gve: qod shi hod fyk
xvv: swe uim fdr
dvm: elx yjr foa ztl quj
fym: gug unz
pxk: qtd pqc uav
gqf: qgg qtd uav
qts: olq qhj
hft: yxn qer rzp
zya: lvp dan cxn pxk
skp: tcu ams vxo
ukg: okt
hlo: jju rts hjb htm
iig: eyz hjc yqe
dhl: ore
lml: xpn
wji: wyg klr yod
umt: amw sij hxi xip rkw
inu: ueh
tqz: uhy rbb ywl
afe: xqa jwk
dsp: xpk zya lts
chx: cjf mrt ojs ybw
ybw: zok
tay: fft
lnt: tqz
gxa: oqa qhj evk hrz olq
yqe: qtd qgg pqc
mll: tti rra vdr sfh xms bfr nhi hpo tic rws ybr
tve: skw ecn
oqa: out
jju: nde wkd whh xlt yno cjx vqq evg xnt dhl xys qom tfb oje
tpa: out
hlv: alh vmq tyf mwe
ekg: ywl lzy rbb
tqb: xcb btr
kqq: aht ulo ubi xsv wgh mim aoy xvv zbb nrs hvg ure ywp gtv bpn wjn sku bnv jos smi czb
shc: qtw dyl oid yfm
qom: dyy
lmi: atr ssy
oje: ore
nrx: jpj
bjq: srk hin inu
fdr: dac mpr jjx
wjb: csl xag ans
ybr: bjq uxb
cxy: pqc qtd qgg
cuu: eyz hjc
ryx: sdr xsd fvi
mjr: beg
hzx: hjb rts
sql: vpk ukg
brz: sur ufh fnt
ubx: hjb rts
qtq: tyf vmq alh mwe nay
jos: uim pty
hvg: gce lml
xuz: fgt
ctg: ise vtx isk
hod: mll zec
kaw: jju hjb
nyh: sij amw rkw hxi
zqz: bic ylg
for: wuk jth okt
hha: gfy jqj aml nly
fvi: jwk
tsm: rzp
zkb: avv yuq mvt bsx
deg: quj
lzy: scp pbc
rts: xys dhl xff qom bla tfb ifl lru oje zll nde rkj gui whh xlt cjx yno vqq evg
fft: hlo czi qdk
zwn: cxy
iyd: atp dbq bwh
ore: qer rzp
mpr: nrx
elf: deg dvm avq ses
qhi: srn
dwp: hva
zbb: eyf lhc
uff: uar
net: kes ffw
ueh: xip sij
mje: hpm pam ubx
owz: bgq msd njb
tvy: yon xui aks uar
xnt: lba
wiu: yyx uff zzd
qzi: uff tvy
ewx: qgg qtd
gao: hlv
ise: ggs
rzr: uav pqc
zik: rzr ewx nzq
icu: pqc uav qtd
nso: ipn
ltt: lwu ntd
sfo: qtd uav
bvl: qtd
xew: alh tyf mwe nay
xfs: bjq
hin: ioe nyh fuy ueh
qer: ldj pqr mog bov
hxi: vlq
jie: fmi hvu
oxv: kvi rkm cuu
cgl: htm
kqt: pcu ngp
yog: ftb
rhm: fvi xsd sdr bpa
nzq: pqc
jpv: usz
bux: ccs gao hbk
uzn: out
gje: smm hqe
adm: beg bvu kdu
ygo: qtd pqc
fmi: ofd gvq bvu beg
bla: wuo smx
lhc: mor vcs yga
hpo: jie
umq: gbx
qhj: out
hcq: rvi oot dsp
ygd: mbz uzn tpa
aep: ewx cxy rzr
cre: jwk kqq kye xqa
scp: kqq kye xqa
ehy: vcm zcw
hvy: pqc qgg qtd
mnn: qnb
ure: afq fdr
ylg: svh kes ffw
fuy: rkw
rhl: xxv ses avq deg
ngp: ggg ltt
qnn: zwy dwp jrq yfd
tyf: kqq jwk kye
lyn: yfm qtw dyl
mrq: wwy chx fzs weu
zec: qnn rws rig xjc vdr sfh hwd rqs tti
yga: hpi ftb
hwd: bjq jlg
kth: njb msd yim
cgc: tly ryx
ggg: lwu
jrq: hva
eyf: yga ysl yog
gfy: pcu gmy
aoy: kej qzi
xmu: xlq lyn
oqu: out
oeu: chx
irt: fhj aus dcm
yce: hod fyk qod sit
fgk: kye xqa jwk
gzp: iwx qhi kjv
ldj: iql rzm
fnt: ise
rvi: zya
czb: lhc eyf
tfb: ljm
weu: ybw
okt: tot mrh
tic: uxb
pcu: gmi ltt
ilr: rdr tux
wob: vlf gcq
csl: avk
kjy: ubx hpm
tti: rdr hhb
cjx: xjw yom fqn oeu
wvy: zcr
wwy: ojs mrt cjf
yrx: ipn wjb
xba: hjb
yzw: qgg pqc
rra: dcl eaf xmu
gbx: htm hjb jju
uva: fgt cyx rvk
nay: kye xqa jwk
kjv: bxp xba
zcw: wrz qlj
smx: wop pxw
aus: pzy puq
oid: qts gxa
hac: njb
rbb: scp pbc
pbc: jwk xqa
kes: iql zok xrg rzm
mbz: out
rtt: nzq
uhy: scp pbc gjq fgk
nop: out
dth: vvw gov tqb kla cih xxb klt ybg qvh nzs elf oks xjt rhl jpv mva fmd hcq qbj
bmk: pzy
vxm: jrq yfd xhf
zzd: aks xui
llp: xns doc
kzd: ctg
sqm: skp
wgm: yod sbb
dbq: ypc qmv
hdk: llp
xxv: quj ztl foa yjr
ufk: yqe oyc eyz
oyc: qgg
qbj: deg avq dvm xxv
ntd: xrg iql
ffw: rzm
yxn: bov mog pqr
msu: gcq vlf mll zec you
hva: wye
shi: you gcq mll vlf
jmh: tcu yaw ams fym
svh: iql xrg rzm
jpj: zec vlf
uav: mnn brz yrx etm okw qsv nso
hqe: avp wob
hew: wyg
wrt: vlf mll zec
wyc: you gcq mll
eaf: xhl
amw: nop fbq fkf vlq
cih: usz xcb btr
vxo: umv
smi: zwl vcm ycv zcw
sdr: xqa
umv: gcq zec you
fkf: out
xwj: lwu ntd
mhm: jxh pgt ekg
tcu: gug
rzp: bov ldj mog
xjt: dnp zdg wbq
qvh: rtt aep zik zwn
bem: nrx hqe
fbq: out
cjf: rzm xrg iql
uoe: evk
xid: cxn
xjw: weu fzs
pzy: kye
buv: jeg
crg: qbj abl klt xxb tqb qgq jpv mxn rhl vvw
quj: gvv sfo icu
nde: ffh zqz
cvu: bmk dcm vue
czi: hjb rts
mrt: xrg iql
qlj: atr
gmi: lwu
wop: zok xrg rzm
srn: rts jju
mvc: yod klr sbb
xag: rvg umq wvy iyf
njb: hzx kaw
mue: gzp ztj
skw: jju htm
evk: out
lts: lvp cxn
sku: zwl
gvv: qtd qgg uav
dul: pxw qzg
ywl: pbc gjq fgk
xys: qtz
qsv: msd bgq yim
avp: mll you
hbk: esi xew hlv
swe: gje bem mpr jjx
scj: xag
yyx: xui yon
qov: out
kvi: hjc
nly: gmy ere pcu ngp gii
yqg: hlv qtq
nol: vcs yga ysl
wsz: zok iql xrg
rkj: tsm hft
rzm: iaf lnt opb zoa uum xxq ygm cgc zgu hdk cog irt cvu ete nkv ifw qce ggu yvi bux
ebx: ipn scj fmm
vvw: kvi ufk iig
tnc: cbl ajk gve yce
amz: inu zhs mzv hin
ygm: qgu tly rhm
yom: weu wwy chx jaw
ytt: zvu
trg: jmh skp xpn
uak: doc uva xuz
rkm: yqe hjc
lvi: yim bgq njb
ssy: mll vlf
bpn: lhc
aml: gii ere gmy pcu
ycv: lmi ayq
mwe: xqa kye
ptv: zok iql xrg rzm
dmt: bsx tay avv
dcl: lyn
ysl: dko
atp: ypc
zok: ifw iaf hdk cgc zoa
yod: yzw bvl ygo
ulo: sqm trg
rdr: sql maj
wki: cbl yce gve
ans: umq wvy
xsd: xqa kqq
qgu: cre bpa xsd sdr
rqy: shc xhl lyn
rkw: azt
nnt: ybg nzs kla xxb tqb vvw mxn gov hcq abl qbj fmd qgq mva elf oks oxv rhl xjt
mim: nol lhc eyf
ojs: xrg rzm zok
qmv: out
cyx: kye jwk
zhs: ioe umt fuy ueh
ses: elx
yon: zec you vlf
fyk: mll gcq you
ofd: fwv
hvu: ofd gvq
smm: wrt avp etj wob
yuq: usj tve
qtz: bic
rvk: xqa
ljm: ylg bic net
esi: vmq tyf nay
jjx: nrx
qzg: xrg rzm iql
ysa: wjb ipn fmm scj
ybg: oot rvi ggj dsp
mog: rzm xrg
afq: jjx dac mpr bem
fme: lhc
lgx: wsz qgt fmr
yim: kaw eqe hzx
ehu: uva xns xuz
ayq: ssy wyc atr
ipn: pky xag
zwy: dzh oqs
tot: out
xql: bpa xsd cre
ete: ekg pgt jxh
rvv: htm rts hjb jju
fgt: kye xqa kqq
sur: isk
byj: wiu kej
qgg: oru nso ebx owz ysa qsv etm yrx kzd mnn kth
nxo: mll gcq you zec
wgh: afq swe
kqv: oqu uzn
zwl: qlj ayq wrz lmi
zll: xjw yom oeu
dko: gcq mll vlf you
bdf: atp zvu jem
oqs: bdf iyd ytt
sfh: roo hws
nkf: abl nzs hcq cih kla tqb jpv oks
pby: ajk yce
bpa: kye
nzs: avq dvm xxv ses
pty: jjx mpr bem
dyl: gxa qts
ufh: ise vtx
jeg: pqc qtd qgg
xhl: yfm oid onj qtw
dan: uav qgg qtd
wjn: wki tnc pby